@@@@@@@@@@@@@@@@@@@@@@@@@@@@@@@@@@@@@@@@@@@@@@@@@@@@@@@@@@@@@@@@@@@@@@@@@@@@@@@@@@@@@@@@@@@@@@@@@@@@@@@@@@@@@@@@@@@@@@
@@@@@@@@@@@@@@@@@@@@@@@@@@@@@@@@@@@@@@@@@@@@@@@@@@@@@@@@@@@@@@@@@@@@@@@@@@@@@@@@@@@@@@@@@@@@@@@@@@@@@@@@@@@@@@@@@@@@@@
@@..................@@..................@@..................@@..................@@..................@@......@@......@@
@@..................@@..................@@..................@@..................@@..................@@@@@@..@@@@@@..@@
@@..................@@..................@@..................@@..................@@..................@@......@@......@@
@@..................@@..................@@..................@@..................@@..................@@@@@@..@@@@@@..@@
@@..................@@..................@@..................@@..................@@..................@@......@@......@@
@@..................@@..................@@..................@@..................@@..................@@@@@@..@@@@@@..@@
@@..................@@..................@@..................@@..................@@..................@@......@@......@@
@@..................@@..................@@..................@@..................@@..................@@@@@@..@@@@@@..@@
@@..................@@..................@@..................@@..................@@..................@@......@@......@@
@@..................@@..................@@..................@@..................@@..................@@......@@......@@
@@@@@@@@@..@@@@@@@@@@@@@@@@@@..@@@@@@@@@@@@@@@@@@..@@@@@@@@@@@@@@@@@@..@@@@@@@@@@@@@@@@@@..@@@@@@@@@@@@@..@@@@@@..@@@@
@@@@@@@@@..@@@@@@@@@@@@@@@@@@..@@@@@@@@@@@@@@@@@@..@@@@@@@@@@@@@@@@@@..@@@@@@@@@@@@@@@@@@..@@@@@@@@@@@@@..@@@@@@..@@@@
@@..................................................................................................................@@
@@..................................................................................................................@@
@@..................................................................................................................@@
@@..................................................................................................................@@
@@@@@@@@@..@@@@@@@@@@@@@@@@@@..@@@@@@@@@@@.......@@@........@@@@@@@@@..@@@@@@@@@@@@@@@@@@..@@@@@@@@@@@@@..@@@@@@..@@@@
@@@@@@@@@..@@@@@@@@@@@@@@@@@@..@@@@@@@@@@@.......@@@........@@@@@@@@@..@@@@@@@@@@@@@@@@@@..@@@@@@@@@@@@@..@@@@@@..@@@@
@@..................@@..................@@..................@@..................@@..................@@......@@......@@
@@..................@@..................@@..................@@..................@@..................@@......@@......@@
@@..................@@..................@@..................@@..................@@..................@@......@@......@@
@@..................@@..................@@..................@@..................@@..................@@......@@@@@@@@@@
@@..................@@..................@@.......@@@........@@..................@@..................@@......@@@@@@@@@@
@@..................@@..................@@.......@@@........@@..................@@..................@@......@@......@@
@@..................@@..................@@..................@@..................@@..................@@..............@@
@@..................@@..................@@..................@@..................@@..................@@..............@@
@@..................@@..................@@..................@@..................@@..................@@......@@......@@
@@..................@@..................@@..................@@..................@@..................@@......@@......@@
@@@@@@@@@@@@@@@@@@@@@@@@@@@@@@@@@@@@@@@@@@.......@@@........@@@@@@@@@@@@@@@@@@@@@@@@@@@@@@@@@@@@@@@@@@@@@@@@@@@@@@@@@@
@@@@@@@@@@@@@@@@@@@@@@@@@@@@@@@@@@@@@@@@@@.......@@@........@@@@@@@@@@@@@@@@@@@@@@@@@@@@@@@@@@@@@@@@@@@@@@@@@@@@@@@@@@
@@@@@@@@@@@@@@@@@@@@@@@@@@@@@@@........................................@@@@@@@@@@@@@@@@@@@@@@@@@@@@@@@@@@@@@@@@@@@@@@@
@@@@@@@@@@@@@@@@@@@@@@@@@@@@@@@........................................@@@@@@@@@@@@@@@@@@@@@@@@@@@@@@@@@@@@@@@@@@@@@@@
@@@@@@@@@@@@@@@@@@@@@@@@@@@@@@@........................................@@@@@@@@@@@@@@@@@@@@@@@@@@@@@@@@@@@@@@@@@@@@@@@
@@@@@@@@@@@@@@@@@@@@@@@@@@@@@@@........................................@@@@@@@@@@@@@@@@@@@@@@@@@@@@@@@@@@@@@@@@@@@@@@@
@@@@@@@@@@@@@@@@@@@@@@@@@@@@@@@........................................@@@@@@@@@@@@@@@@@@@@@@@@@@@@@@@@@@@@@@@@@@@@@@@
@@@@@@@@@@@@@@@@@@@@@@@@@@@@@@@........................................@@@@@@@@@@@@@@@@@@@@@@@@@@@@@@@@@@@@@@@@@@@@@@@
@@@@@@@@@@@@@@@@@@@@@@@@@@@@@@@........................................@@@@@@@@@@@@@@@@@@@@@@@@@@@@@@@@@@@@@@@@@@@@@@@
@@@@@@@@@@@@@@@@@@@@@@@@@@@@@@@........................................@@@@@@@@@@@@@@@@@@@@@@@@@@@@@@@@@@@@@@@@@@@@@@@
@@@@@@@@@@@@@@@@@@@@@@@@@@@@@@@........................................@@@@@@@@@@@@@@@@@@@@@@@@@@@@@@@@@@@@@@@@@@@@@@@
@@@@@@@@@@@@@@@@@@@@@@@@@@@@@@@........................................@@@@@@@@@@@@@@@@@@@@@@@@@@@@@@@@@@@@@@@@@@@@@@@
@@@@@@@@@@@@@@@@@@@@@@@@@@@@@@@........................................@@@@@@@@@@@@@@@@@@@@@@@@@@@@@@@@@@@@@@@@@@@@@@@
@@@@@@@@@@@@@@@@@@@@@@@@@@@@@@@........................................@@@@@@@@@@@@@@@@@@@@@@@@@@@@@@@@@@@@@@@@@@@@@@@
@@@@@@@@@@@@@@@@@@@@@@@@@@@@@@@........................................@@@@@@@@@@@@@@@@@@@@@@@@@@@@@@@@@@@@@@@@@@@@@@@
@@@@@@@@@@@@@@@@@@@@@@@@@@@@@@@........................................@@@@@@@@@@@@@@@@@@@@@@@@@@@@@@@@@@@@@@@@@@@@@@@
@@@@@@@@@@@@@@@@@@@@@@@@@@@@@@@@@@@@@@@@@@@@@@@@@@@@@@@@@@@@@@@@@@@@@@@@@@@@@@@@@@@@@@@@@@@@@@@@@@@@@@@@@@@@@@@@@@@@@@
@@@@@@@@@@@@@@@@@@@@@@@@@@@@@@@@@@@@@@@@@@@@@@@@@@@@@@@@@@@@@@@@@@@@@@@@@@@@@@@@@@@@@@@@@@@@@@@@@@@@@@@@@@@@@@@@@@@@@@
